[
----------------------------|
-                          -|
-                          -|
-     -----                -|
-                          -|
-                          -|
-                          -|
-    -----                 -|
-                          -|
-                          -|
-                          -|
-   -----                  -|
-                          -|
-                          -|
-                          -|
----------------------------|
]
player 1 15
/